##### ####### #####
#.... #.....# ....#
#O##. #.###.# .##O#
...................
##.#.###.#.###.#.##
##.#.###.#.###.#.##
  .#.....#.....#.  
#.###  #####  ###.#
#.       F       .#
#. ### ##-## ### .#
#. #   #HGJ#   # .#
#. ##  #####  ## .#
 .  #..  .  ..#  . 
#.###### # ######.#
#......  # .......#
#.##### ###.#####.#
#........P........#
#.##.###.#.###.##.#
#.##.#...#...#.##.#
#O##.#.#####.#.##O#
 .#  #  ###  #  #. 
#.................#
##### ####### #####